NO Makefile
SO Makefile
EA Makefile
WE Makefile
F 220,100,1
C 34,54,34
1111111
1001011
1010011
1100N11
1111111
