NO ./path_to_the_north_texture
SO ./path_to_the_east_texture
WE ./path_to_the_west_texture
EA ./path_to_the_east_texture
F 220,78,300
C 225,30,0

        1111111111111111111111111
        1000000000110000000000001
        1011000001110000000000001
        1001000000000000000000001
111111111011000001110000000000001
100000000011000001110111111111111
11110111111111011100000010001
11110111111111011101010010001
11000000110101011100000010001
100000S00010000011000000100011
1000000001110000001101010010001
1100000111 10101111101111000111
11110111111101011101111010001
1111111111111111111111111111111111
11111111 1111101 100011101
11111111 1111111 1111111111111111









