NO textures/monstre.xpm
WE textures/chat2.xpm
EA textures/chat3.xpm
SO textures/chat4.xpm

F 40,40,40
C 10,33,146

        1111111111111111111111111
        1000000000110000000000001
        1011000001110000000000001
        1001000000000000000000001
111111111011000001110000000000001
100000000011000001110111111111111
11110111111111010000000000001
11110111111111011101011011101
1100000011111101111 111011101
100000000010000011010110111011
100000000111000000110100111N11
1100000111 1010110010111101111
11110100001101011101111000001
1111111110000111110111101111111111
1111111111111111111111111111111111
11111111111111111111111111
11111111 1111101 100000001
11111111 1111111 1111111111111111
