NO textures/wall1.xpm
SO textures/wall2.xpm
WE textures/wall3.xpm
EA textures/wall4.xpm
F 224,182,54
C 153,255,255

11111111111111111111
10000000000000000001
10111111111101111101
10000010000001000001
11111110111111011111
10000000100000000001
10111111101111111001
10000000001000000001
11111111111101111111
10000000000001000001
10111101111111011101
10001001000001000001
11101011111011111011
10001000001000000001
10111111101111111001
10000000001000000001
11111111111101111111
10000000000001000001
10111111111111011101
10000000000000000N01
11111111111111111111










