NO textures/chat.xpm
WE textures/chat2.xpm
EA textures/chat3.xpm
SO textures/chat4.xpm


F 75,75,75
C 34,0,84

1111111
1001011
1010011
1100N11
1111111
