NO textures/mossy.xpm
WE textures/bois.xpm
EA textures/wood.xpm
SO textures/stone.xp

F 75,75,75
C 116,229,252

1111111
1001011
1010011
1100N11
1111111
