NO ./path_to_the_north_texture
SO ./path_to_the_south_texture
WE ./path_to_the_west_texture
EA ./path_to_the_east_texture

F 220,100,255
C 225,30,0

1111111
1001010
1010011
1100N11
1111111
