NO textures/mur_mario.xpm
WE textures/mur_mario.xpm
EA textures/mur_mario.xpm
SO textures/mur_mario.xpm

F 75,75,75
C 116,229,252

1110111
1000011
10S0011
1100011
1111111
