NO textures/chat.xpm
SO textures/chat4.xpm
WE textures/chat2.xpm
EA textures/chat3.xpm
F 75,75,75
C 153,255,255

        1111111111111111111111111
        1000000000110000000000001
        1011000001110000000000001
        1001000000000000000000001
111111111011000001110000000000001
100000000011000001110111111111111
11110111111111011100000010001
11110111111111011101010010001
11000000110101011100000010001
100000E00010000011000000100011
1000000001110000001101000010001
1100000111 10101100101111010111
11110100001101011101111000001
1111111110000111110111101111111111
1111111111111111111111111111111111
11111111111111111111111111
11111111 1111101 100000001
11111111 1111111 1111111111111111









